13 5
  ###########
  #.........#
  #..p...r..#
  #.........#
  ###########