28 8
  ##########################
  #..p...d.................#
  #......#.................#
  #......#####.....#########
  #......#.................#
  #.k....#..............e..# 
  #......#.................#
  ##########################