20 8           
####l###l###l#######
l.........k......p.#
#..................#
#d#l##l###l#########
#......l            
l.s.s..l            
#.....e#            
##lll###            
