22 8
  ####################
  #..p...d.....w.....#
  #......#...........#
  #......#############
  #......#...s.......#
  #.k....#....s...e..# 
  #.....t#t..s.......#
  ####################