28 8
  ##########################
  #.....sx..#..............l
  #......#.....####.......e#
  #.....c###################
  #......#                  
  #.p....#                   
  #......#                  
  ########                  