28 8
  ##########################
  #......d...s.............l
  #......#.l...lll.........#
  #.....k#...s........s..###
  #......########l###l##...#
  #.p....#    #.e.....s....# 
  #......#    #.....s......#
  ########    #####l####l###