28 8
  ##########################
  #..p...d..#..............l
  #......#.....####.......e#
  #......###################
  #......#                  
  #.k....#                   
  #......#                  
  ########                  