22 8
  ####################
  #..p.###..s..#..k..#
  #............#.....#
  #.##################
  #.....t#ts.#####...#
  #......#.....d..e..#
  #......#.s.#####...#
  ####################