25 8           
#########################
#.....................p.#
#.......................#
#......##################
#......#                 
#..e...#                 
#......#                 
########                 
