22 8
  ####################
  #..p........w......#
  #......#...........#
  #......#############
  #......#...s.......#
  #.k....d....s...e..# 
  #......#...s.......#
  ####################