28 8
  ##########################
  #..p...d.................#
  #......#.................#
  l......#####.....#########
  #......#.................#
  #.k....#..............e..# 
  #......#.................#
  #####l####################