28 8
  ##########################
  #.....sx..#..............l
  #......#.....####.......e#
  #.....o###################
  #......#                  
  #.p....#                   
  #......#                  
  ########                  