22 8
  ####################
  #..p.###.....#.....#
  #....###.....#.....#
  #.##################
  #......#...#####...#
  #.c....#...#####e..# 
  #......#...#####...#
  ####################