28 8
  ##########################
  #..p...x..#..............l
  #......#.....####.......e#
  #......###################
  #......#                  
  #.c....#                   
  #......#                  
  ########                  